111111111111111111111111111111
100000000P00000000000000000001
1000CCC00000001110000000000001
100000000110000000100000000001
100C00000110001100000000000001
100000000000001100000000000001
1000C0000000CC0000000000000001
100000000000000000000000000001
100000000000000000000000000001
111111110000000000000000000001
111111110000000000000000000001
1000000000000C0000000000000001
100000000000000000000000000001
111100000000000000000000000001
1E0C00000000000000000000000001
111111111111111111111111111111
