11111111111111111111
100000000P0000000001
1000CCC0000000111001
10000000011000000011
100C0000011000110001
10000000000000110001
1000C0000000CC000001
10000000000000000001
10000000000000000001
11111111000000000001
11111111000000000001
1000000000000C000001
10000000000000000001
11110000000000000001
1E0C0000000000000001
11110000000000000001
10000000000000000001
10000000000000000001
10000000000C00000001
11111111111111111111
