11111
11111
11P11
11C11
11E11
11001
11111
