11111
11101
11P11
11011
11C11
110E1
11111
