11111
11101
11P11
11011
11C11
11EE1
11111
