11111
11P11
110C1
1CCE1
11111
