111111111111111111111111111111
10C011110000001000000011111111
100011100000000000011111111111
100000001110000000111111111111
10100000111000110011E111111111
100P00001110001100000011111111
110000000000000000000111111111
111111100000000111111111111111
111111100000000111111111111111
111000000000000111111111111111
111C00000000000111111111111111
111111100000000000000001111111
111111111000000000000C01111111
111111111111111111111111111111
111111111111111111111111111111
