1111111111
10001E1001
100C0CC0C1
1CCC0CC0C1
100CC0CCC1
1C000CCCC1
1111011111
1000000001
1000P00001
1111111111
